..............................
.....########.................
.....#......#.................
.....#......#.................
.....#..@...#.................
.....#......#.................
.....#......#.................
.....###..###.................
.......#.#....................
.......#.#....................
.......#.######...............
.......#......#...............
.......######.#...............
............#.#...............
............#.#...............
.......######.#######.........
.......#............#.........
.......#............#.........
.......#............#.........
.......#............#.........
.......#...<........#.........
.......#............#.........
.......#............#.........
.......#............#.........
.......##############.........
..............................
..............................
..............................
..............................
..............................