..............................
..............................
..............................
..............................
..............................
..............................
..............................
..............................
.....###############..........
.....#.............#..........
.....#...>.........#..........
.....#.............#..........
.....#.............#..........
.....#.............#..........
.....#.............#..........
.....#.............#..........
.....###############..........
..............................
..............................
..............................
..............................
..............................
..............................
..............................
..............................
..............................
..............................
..............................
..............................
..............................